feature	type	start	end	length	color
ORF1a	CDS	265	13483	13218	#636EFA
ORF1b	CDS	13483	21555	8072	#EF553B
S	CDS	21562	25384	3822	#00CC96
ORF3a	CDS	25392	26220	828	#AB63FA
E	CDS	26244	26472	228	#FFA15A
M	CDS	26522	27191	669	#19D3F3
ORF6	CDS	27201	27387	186	#FF6692
ORF7a	CDS	27393	27755	362	#B6E880
ORF7ab	CDS	27755	27759	4	#FF97FF
ORF7b	CDS	27759	27887	128	#FECB52
ORF8	CDS	27893	28259	366	#636EFA
N	CDS	28273	29533	1260	#EF553B
ORF10	CDS	29557	29674	117	#00CC96
